{
    "mapName": "YourMapName",
    "mapSizeX": 10,
    "mapSizeY": 10,
    "weather": 0,
    "lighting": {
      "r": 255,
      "g": 255,
      "b": 255,
      "a": 255
    },
    "groundLayer": [
      [5, 4, 4, 6, 4, 4, 4, 4, 4, 4],
      [5, 4, 4, 6, 4, 4, 4, 4, 4, 4],
      [5, 4, 4, 6, 4, 4, 4, 4, 4, 4],
      [5, 4, 4, 6, 4, 4, 4, 4, 4, 4],
      [5, 4, 4, 6, 4, 4, 4, 4, 4, 4],
      [5, 4, 4, 6, 4, 4, 4, 4, 4, 4],
      [5, 4, 4, 6, 4, 4, 4, 4, 4, 4],
      [5, 4, 4, 6, 4, 4, 4, 4, 4, 4],
      [5, 4, 4, 6, 4, 4, 4, 4, 4, 4],
      [6, 6, 6, 6, 6, 6, 6, 6, 6, 6]
    ],
    "overlayLayer": [
      [0, 0, 0, 0, 0, 0, 0, 0, 0, 0],
      [0, 0, 0, 0, 0, 0, 0, 0, 0, 0],
      [0, 0, 0, 0, 0, 0, 0, 0, 0, 0],
      [0, 0, 0, 0, 0, 0, 0, 0, 0, 0],
      [0, 0, 0, 0, 0, 0, 0, 0, 0, 0],
      [0, 0, 0, 0, 0, 0, 0, 0, 0, 0],
      [0, 0, 0, 0, 0, 0, 0, 0, 0, 0],
      [0, 0, 0, 0, 0, 0, 0, 0, 0, 0],
      [0, 0, 0, 0, 0, 0, 0, 0, 0, 0],
      [0, 0, 0, 0, 0, 0, 0, 0, 0, 0]
    ],
    "wallLayer": [
      [0, 0, 0, 0, 0, 0, 0, 0, 0, 0],
      [0, 0, 0, 0, 0, 0, 0, 0, 0, 0],
      [0, 0, 0, 0, 0, 0, 0, 0, 0, 0],
      [0, 0, 0, 0, 0, 0, 0, 0, 0, 0],
      [0, 0, 0, 0, 0, 0, 0, 0, 0, 0],
      [0, 0, 0, 0, 0, 0, 0, 0, 0, 0],
      [0, 0, 0, 0, 0, 0, 0, 0, 0, 0],
      [0, 0, 0, 0, 0, 0, 0, 0, 0, 0],
      [0, 0, 0, 0, 0, 0, 0, 0, 0, 0],
      [0, 0, 0, 0, 0, 0, 0, 0, 0, 0]
    ]
  }
  